MMMMMMMMMMMMMMMMMMMEMMMMMMMMMMMMMMMMMMMMMMMMMM
MMMPPPPPPPPMMMMMMMMPMMMMMMMMMMMMMMMMMMMMMMMMMM
MMMMMMMMMMPMMMMMMMMPMMMMMMMMMMMMMMMMMMMMMMMMMM
MMMMMMMMMMPMMMMMMMMPMMMMMMMMMMMMMMMMMMMMMMMMMM
MMMMMMMMMMPPPPPPPPPPPPPPPPPPPPPPPPPPPPPPMMMMMM
MMPMMMMMMMMMMMMMMMMMMMMMMMMMMMMMMMMMMMMPMMMMMM
MMPMMMMMMMPPPPPPPPPPPPPPPPPPPMMMMMMMMMMPMMMMMM
MMPMMMMMMMPMMMMMMMMMMMPMMMMMPMMMMMMMMMMPMMMMMM
MMPMMMMMMMPMMMMMMMMMMMPMMMMMPMMMMMMMMMMPMMMMMM
MMPMMMMMMMPMMMMMMMMMMMPMMMMMPMMMMMMMMMMPMMMMMM
MMPPPPPPPPPPPPPPPPMMMMPMMMMMPMMMMMMMMMMPMMMMMM
MMMMMMMMMMPMMMMMMPMMMMPMMMMMPMMMMMMMMMMPMMMMMM
MMMMMMMMMMPMMMMMMPMMMMPMMMMMPMMMMMMMMMMPMMMMMM
MMMMMMMMMMPMMMMMMPMMMMPMMMMMPMMMMMMMMMMPMMMMMM
MMMMMMMMMMPMMMMMMPMMMMPMMMMMMMMMMMMMMMMPMMMMMM
MMMMMMMMMMPMMMMMMPMMMMPPPPPPPPPPPPPPPPPPMMMMMM
MMMMMMMMMMPMMMMMMMMMMMMMMMMMMMMMMMMMMMMMMMMMMM
MMMMMMMMMMPPPPPPMMMMMMMMMMMMMMMMMMMMMMMMMMMMMM
MMMMMMMMMMMMMMMPMMMMMMMMMMMMMMMMMMMMMMMMMMMMMM
MMMMMMMMMMMMMMMSMMMMMMMMMMMMMMMMMMMMMMMMMMMMMM