MMMMMMMMMMMMMMMMMMMEMMMMMMMMMMMMMMMMMMMMMMMMMM
MMMPPPPPPPPMMMMMMMMPMMMMMMMMMMMMMMMMMMMMMMMMMM
MMMPMMPMMMPMMMMMMMMPMMMMMMMMMMMMMMMMMMMMMMMMMM
MMMPPPPMMMPMMMMMMMMPMMMMMMMMMMMMMMMMMMMMMMMMMM
MMMMMMMMMMPPPPPPPPPPPPPPPPPPPPPPPPPPPPPPMMMMMM
MMPMMMMMMMMMMMMMMMMMMMMMMMMMMMMMMMMMMMMPMMMMMM
MMPMMMMMMMPPPPPPPPPPPPPPPPPPPMMMMMMMMMMPMMMMMM
MMPMMMMMMMPMMMMMMMMPMMPMMMMMPMMMMMMMMMMPMMMMMM
MMPMMMMMMMPMMMMMMMMPMMPMMMMMPMMMMMMMMMMPMMMMMM
MMPMMMMMMMPMMMMMMMMPPPPMMMMMPMMMMMMMMMMPMMMMMM
MMPPPPPPPPPPPPPPPPMMMMPMMMMMPMMMMMMMMMMPMMMMMM
MMPMMMMMMMPMMMMMMPMMMMPMMMMMPMMMMMMMMMMPMMMMMM
MMPMMMMMMMPMMMMMMPMMMMPMMMMMPMMMMMMMMMMPMMMMMM
MMPPMMMMMMPMMMMMMPMMMMPMMMMMPMMMMMMMMMMPMMMMMM
MMMPPMMMMMPMMMMMMPMMMMPMMMMMMMMMMMMMMMMPMMMMMM
MMMMPPMMMMPMMMMMMPMMMMPPPPPPPPPPPPPPPPPPMMMMMM
MMMMMPPMMMPMMMMMMMMMMMMMMMMMMMMMMMMMMMMMMMMMMM
MMMMMMPMMMPPPPPPMMMMMMMMMMMMMMMMMMMMMMMMMMMMMM
MMPPPPPMMMMMMMMPMMMMMMMMMMMMMMMMMMMMMMMMMMMMMM
MMMMMMMMMMMMMMMSMMMMMMMMMMMMMMMMMMMMMMMMMMMMMM