MMMMMMMMMMMMMMMMMMMMMMMMMMMMMMMMMMMMMMMMMMMMMMMMMMMMMMMMMMMMMMMSMMM
MMPPPPPPPPMMMMMMMMMMMMMMMMMMMMMMMMMMMMMMMMMMMMMMMMMMMMMMMMMMMMMPMMM
MMPMMMMMMPMMMMMMMMMMMMMMMMMMMMMMMMMMMMMMMMMMMPPPPPPPPPPPPPPPPPPPMMM
MMPMMMMMMPMMMMMMMMMMMMMMMMMMMMMMMMMMMMMMMMMMMPMMMMMMMMMMMMMMMMMMMMM
MMPMMMMMMPMMMPPPPPPPPPPPPPPPPPPPPPPPPPPPPPPPPPPPPPPPPPPPPPPPPPPPMMM
MMPMMMMMMPMMMMMPMMMMMMMMMMMMMMMMMMMMMMMMMMMPMPMMMMMMMMMMMMMMMMPMMMM
MMPPPPPPPPPPPPPPPPPPPPPPPPMMMMMMMMMMMMMMMMMPMPMMMMMMMMMMMMMMMMPMMMM
MMMMMMMMMPMMMMMPMMMMMMMMMPMMMMPMMMMMMMMMMMMPMPMMMMMMMMMMMMMMMMPMMMM
MMMMMMMMMPMMMMMPMMMMMMMMMPMMMMPMMMMMMMMMMMMPMPMMMMMMMMMMMMMMMMPMMMM
MMMMMMMMMPMMMMMPMMPPPPPPPPPPPPPPPPPPPPPPPPPPPPMMMMMMMMMMMMMMMMPMMMM
MMMMMMMMMPMMMMMPMMMMMMMMMPMMMMPMMMMMMMMMMMMPMPMMMMMMMMMMMMMMMMPMMMM
MMMMMMMMMPMMMMMPMMMMMMMMMPMMMMPMMMMMMMMMMMMPMPMMMPPPPPPPPPMMMMPMMMM
MMMMMMMMMPMMMMMPMMMMMMMMMPMMMMPMMMMMMMMMMMMPMPMMMPMMMMMMMPMMMMPMMMM
MMMMMMMMMPMMMMMPMMMMMMMMMPMMMMPMMMMMMMMMMMMPMPMMMPMMMMMMMPMMMMPMMMM
EPPPPPMMMPMMMMMPMMMMMMMMMPMMMMPMMMMMMMMMMMMPMPMMMPMMMMMMMPMMMMPMMMM
MMMMMPMMMPMMMMMPMMMMMMMMMPMMMMPMMMMMMMMMMMMPMPMMMPMMMMMMMPMMMMPMMMM
MMPPMPMMMPMMMMMPMMMMMMMMMPMMMMPMMMMMMMMMMMMPMPMMMPMMMMMMMPMMMMPMMMM
MMPPPPMMMPMMMMMPMMMMMMMMMPMMMMPMMMMMMMMMMMMPMPMMMPMMMMMMMPMMMMPMMMM
MMMMMPMMMPMMMMMPPPPPPPPPPPPPPPPPPPPMMMMMMMMPMPMMMPMMMMMMMPMMMMPMMMM
MMMPMPMMMPMMMMMMMMMMMMMMMPMMMMPMMMMMMMMMMMMPMPPPPPMMMMMMMPMMMMPMMMM
MMMPMPMMMPMMMMMMMMMMMMMMMPMMMMPMMMMMMMMMMMMPMMMMMMMMMMMMMPMMMMPMMMM
MMMPMPMMMPMMMMMMMMMMMMMMMPMMMMPMMMMMMMMMMMMPMMMMMMMMMMMMMPMMMMPMMMM
MMMPMPMMMPMMMMMMMMMMMMMMMPMMMMPMMMPPPPPPPPPPPPPPPPPPPPPMMPMMMMPMMMM
MMMPMPMPPPPPPPPPPPPPPMMMMPMMMMPMMMMMMMMMMMMPMMMMMMMMMPMMMPMMMMPMMMM
MMMPMPMMMPMMMMMMMMMMMMMMMPMMMMPMMMMMMMMMMMMPMMMMMMMMMPMMMPMMMMPMMMM
MMMPMPMMMPMMMMMMMMMMMMMMMMMMMMPMMMMMMMMMMPMMMMMMMMMMMPMMMPMMMMPMMMM
MMMPMPMMMPMMMMMMMMMMMMMMMMMMMMPMMMMMMMMMMPMMMMMMMMMMMPMMMPMMMMPMMMM
MMMPMPMMMPMMMMMMMPPPPPPPPPPPPPPPPPPPPPPPPPPPPPPPPPPPPPPPPPMMMMPMMMM
MMMPMPMMMPMMMMMMMPMMMMMMMMMMMMPMMMMMMMMMMPMMMMMMMMMMMPMMMMMMMMPMMMM
MPPPPPPPPPPPPPPPPPPPPMMMMMMMMMPMMMMMMMMMMPMMMMMMMMMMMPMMMMMMMMPMMMM
MMMPMPMMMPMMMMMMMPMMMMMMMMMMMMPMMMMMMMMMMPMMMMMMMMMMMPMMMMMMMMPMMMM
MMMPMPMMMPMMMMMMMPMMMMMMMMMMMMPMMMMMMMMMMPMMMMMMMMMMMPMMMMMMMMPMMMM
MMMPMPMMMPMMMMMMMPMMMMMMMMMMMMPMMMMMMMMMMPMMMMMMMMMMMPMMMMMMMMPMMMM
MMMPMPMMMPMMMMMMMPMMMMMMMMMMMMPMMMMMMMMMMPMMMMMMMMMMMPMMMMMMMMPMMMM
MMMPMPMMMPMMMMMMMPPPPPPPPPPPPPPPPPPPPPPPPPPPPPPPPPPPPPMMMMMMMMPMMMM
MMMPPPPPPPMMMMMMMMMMMMMMMMMMMMPMMMMMMMMMMPMMMMMMMMMMMMMMMMMMMMMMMMM
MMMMMMMMMMMMMMMMMMMMMMMMMMMMMMMMMMMMMMMMMMMMMMMMMMMMMMMMMMMMMMMMMMM